,,,,,,4,,,
,,3,,,,,,,
,,,,,,,,3,
,,,,,,2,,,
5,,,,,,,,,
,8,,,,,,,,
,,,1,,,,2,,
,,2,,,,,,,
8,,,,,,,,6,
,,,2,,,,,,
,,,,,,,,,8
,,,,,,,,,
,,,,,,8,,,
,7,,,,,,,,